111111
100001
10C001
1000E1
111111
