111111
1P0001
111111
10C01
1000E1
111111