111111
1P0001
111111
10C001
1000E1
111110