111111
1P0X01
111111
10C0E1
111111