11111111111111111111
1P000000000000000001
10110111101111011001
10000C0000C00000C001
10110111101111011001
10000000000000000001
11011110111101111011
10000001111111110001
11011110111101111011
11111111111111111111
10110111101111011001
1000000000E0000000C1
11111111111111111111