111111
1P0001
10C001
1000E1
111111