11111111111111111111
1C0000000000000000E1
10110111101111011001
100000C0000C00000C01
10110111101111011001
10000000000000000001
11011110111101111011
10C000000P00000C0001
11011110111101111011
10000000000000000001
10110111101111011001
100000000C00000000C1
11111111111111111111